0 0 0 0 0 0 0 0 0 0 0 0 0 0 0 0 0 0 0 0 0 0 0 0 0 0 0 0 0 0 0 0 0 0 0 0 0 0 0 0 
0 2 2 2 2 2 2 3 2 2 6 2 1 3 2 2 2 2 2 1 2 1 2 2 2 2 2 2 2 3 2 2 2 2 1 2 2 2 2 0 
0 2 1 5 1 2 2 2 2 2 2 3 2 2 2 2 2 2 2 2 2 1 6 2 2 1 2 2 2 2 3 2 2 2 2 2 3 2 2 0 
0 2 2 2 2 2 2 2 2 2 2 3 2 2 3 2 2 2 2 2 1 2 1 2 2 1 2 2 2 2 2 2 2 2 1 2 2 2 2 0 
0 1 2 3 3 2 2 2 2 2 2 2 2 2 1 2 2 2 2 2 2 1 2 2 1 2 2 2 2 1 2 2 2 1 2 2 2 2 2 0 
0 1 2 1 1 2 2 2 2 2 2 2 2 2 1 1 2 2 1 2 2 2 2 2 2 2 2 1 2 2 2 2 2 2 1 2 1 3 2 0 
0 2 2 2 1 2 2 1 2 2 2 2 2 2 2 2 1 2 2 2 2 2 1 2 3 1 2 2 2 2 2 2 2 2 1 2 1 1 2 0 
0 7 7 7 7 7 7 7 7 7 7 7 7 7 7 7 7 7 7 7 7 7 7 7 7 7 7 7 7 7 7 2 2 2 1 2 2 1 2 0 
0 2 3 2 2 2 1 2 2 6 2 3 2 2 1 2 1 2 2 2 2 2 2 2 2 2 2 6 2 1 3 2 2 2 2 2 2 1 2 0 
0 2 2 6 2 2 2 2 2 1 2 2 2 2 2 3 2 2 2 2 2 2 2 2 1 3 3 1 2 2 6 2 2 2 2 1 2 2 2 0 
0 2 2 2 1 2 2 1 2 1 2 2 2 2 2 2 2 2 2 2 2 2 2 2 1 1 2 1 2 2 1 2 2 2 2 2 2 2 2 0 
0 2 3 2 2 2 2 2 1 2 2 2 2 2 2 2 2 1 1 3 2 2 2 2 2 2 2 1 2 2 1 2 6 2 2 2 2 3 2 0 
0 2 1 2 2 3 2 2 1 2 3 3 2 2 2 2 2 1 2 1 6 2 2 6 2 2 2 2 1 2 2 2 1 2 2 6 2 1 2 0 
0 2 6 1 2 2 2 2 2 2 2 2 2 2 2 2 2 2 1 1 1 2 2 1 2 2 2 2 2 2 2 2 6 2 2 2 2 2 1 0 
0 2 2 2 2 2 2 2 2 7 7 7 7 7 7 7 7 7 7 7 7 7 7 7 7 7 7 7 7 7 7 7 7 7 7 7 7 7 7 0 
0 3 3 2 2 2 2 2 2 2 2 2 3 2 2 2 6 2 2 2 2 1 2 2 2 2 2 1 2 2 2 1 2 2 2 2 2 2 2 0 
0 1 3 2 2 2 2 2 2 2 2 2 1 1 2 2 1 2 2 2 2 2 2 2 2 1 2 2 2 2 2 2 1 2 1 3 2 2 0 0 
0 2 1 2 2 1 2 2 2 2 2 2 2 2 1 2 2 2 2 2 1 2 3 3 2 2 2 2 6 2 2 2 1 2 1 1 2 2 2 0 
0 2 2 2 2 1 6 2 2 3 2 2 2 2 2 2 2 2 1 2 2 2 2 2 2 1 2 1 6 2 2 2 2 2 2 1 2 2 2 0 
0 2 2 2 3 2 2 3 2 1 2 2 1 2 1 1 2 2 2 2 2 2 2 2 2 1 2 1 6 2 2 2 2 2 2 1 2 2 1 0 
0 2 6 2 2 2 2 1 2 2 2 2 2 3 2 2 2 2 2 2 2 2 2 3 2 1 2 2 1 2 2 2 2 1 2 2 2 1 2 0 
0 0 0 0 0 0 0 0 0 0 0 0 0 0 0 0 0 0 0 0 0 0 0 0 0 0 0 0 0 0 0 0 0 0 0 0 0 0 0 0 
