0 0 0 0 0 0 0 0 0 0 0 0 0 0 0 0 0 0 0 0 0 0 0 0 0 0 0 0 0 0 0 0 0 0 0 0 0 0 0 0
0 1 2 7 7 2 7 1 1 2 7 2 2 2 1 7 1 2 2 1 2 2 2 2 7 2 2 2 1 2 2 2 2 2 1 7 2 6 0 0
0 2 2 5 7 2 6 2 1 2 7 2 2 2 7 7 7 2 2 7 2 1 2 2 2 2 1 2 2 1 2 1 2 2 2 7 2 7 1 0
0 2 2 2 2 7 2 2 1 6 2 2 1 2 2 2 2 7 2 2 2 2 2 1 2 7 7 1 2 2 2 2 2 2 2 7 2 7 7 0
0 6 2 7 2 2 7 1 7 1 2 2 1 2 2 2 2 7 2 2 2 1 2 2 2 2 2 2 1 2 1 1 2 2 2 2 2 2 7 0 
0 1 2 7 2 2 2 7 2 2 1 2 7 7 2 2 1 2 7 7 6 2 2 2 2 2 2 2 1 2 1 1 2 2 2 2 2 2 7 0
0 1 1 2 2 1 2 2 2 2 7 2 2 2 1 2 2 2 2 2 2 1 2 1 1 2 2 2 2 2 2 1 2 2 6 7 7 2 2 0
0 2 2 1 2 7 7 2 2 1 2 1 1 2 2 2 7 2 2 2 2 1 2 1 1 2 2 2 2 2 2 7 2 2 1 2 7 2 1 0
0 2 2 7 2 2 2 6 2 2 2 2 2 2 6 2 1 2 2 7 7 1 2 2 1 2 7 2 7 1 2 2 7 1 2 2 6 2 1 0
0 1 2 1 2 2 2 2 7 2 7 7 2 2 6 2 1 2 2 7 7 1 2 2 1 2 2 6 1 7 2 2 2 7 2 2 1 2 7 0
0 2 1 2 7 7 2 2 2 2 2 1 1 7 1 2 2 6 2 7 2 7 1 2 2 7 1 2 2 2 7 1 2 2 6 2 1 2 2 0
0 7 2 7 7 2 2 2 2 2 2 1 1 7 1 2 2 1 2 7 2 7 7 2 2 2 7 2 2 1 2 7 7 2 2 1 2 7 7 0
0 2 7 2 1 2 1 2 7 2 2 2 7 7 1 2 2 1 2 2 2 2 7 2 2 2 1 2 2 2 2 2 7 7 2 1 2 7 7 0
0 2 7 2 1 2 1 2 7 2 6 2 7 2 7 1 2 2 7 1 2 2 2 2 1 2 2 1 2 1 1 2 2 2 2 7 2 2 2 0
0 7 2 2 7 1 7 1 2 2 1 2 2 2 2 7 2 2 2 6 2 2 2 7 2 1 7 2 2 2 2 2 2 7 2 7 7 2 6 0
0 7 2 2 2 7 7 1 2 2 7 2 6 2 2 2 7 1 2 2 1 2 1 2 2 2 1 2 7 1 2 2 2 2 2 2 7 2 2 0
0 7 2 6 2 2 2 2 1 2 7 7 2 2 1 2 7 7 1 2 2 2 2 2 2 2 1 2 7 1 2 2 2 2 2 2 7 2 2 0
0 2 2 1 2 2 2 2 7 2 2 2 1 2 2 2 2 2 2 1 2 1 1 2 2 2 2 2 2 7 2 2 1 2 7 2 2 2 7 0
0 1 2 7 7 2 2 1 2 7 7 2 2 2 7 2 2 2 2 1 2 1 1 2 2 2 2 2 2 7 2 2 1 6 2 2 1 2 2 0
0 7 2 2 2 1 2 2 2 2 2 2 1 2 1 6 2 2 2 2 2 2 1 2 2 2 7 7 2 2 7 1 2 2 6 2 7 2 2 0
0 1 1 2 2 2 7 2 2 2 2 2 1 2 1 6 2 2 2 2 2 2 7 2 2 1 2 7 6 2 6 2 1 7 2 1 2 2 2 0
0 0 0 0 0 0 0 0 0 0 0 0 0 0 0 0 0 0 0 0 0 0 0 0 0 0 0 0 0 0 0 0 0 0 0 0 0 0 0 0  
